99,99,99,99,99,99,99,99,99,99,99
99,30,31,32,33,99,30,31,32,33,99
99,40,41,42,43,99,40,41,42,43,99
99,50,51,52,53,99,50,51,52,53,99
99,60,61,62,63,99,60,61,62,63,99
99,99,99,99,99,20,99,99,99,99,99
99,30,31,32,33,99,30,31,32,33,99
99,40,41,42,43,99,40,41,42,43,99
99,50,51,52,53,99,50,51,52,53,99
99,60,61,62,63,99,60,61,62,63,99
99,99,99,99,99,99,99,99,99,99,99